333333333333333333333333333
111111111111111111111111111
100000000000111000000000001
101111011110111011110111101
101111011110111011110111101
100000000000000000000000001
101111010111111111010111101
100000010000111000010000001
111111011110111011110111111
111111010000000000010111111
111111010111222111010111111
000000000111000111000000000
111111010111111111010111111
111111010000000000010111111
111111010111111111010111111
100000000000000000000000001
101111101111111111101111101
101111101111111111101111101
101111000000111000000111101
100111011110111011110111001
110111000000000000000111011
110111010111111111010111011
100000010000111000010000001
101111111110111011111111101
100000000000000000000000001
111111111111111111111111111
333333333333333333333333333
